 10  10  11  10  9  9  10  11   
11  12  11  10  10  10  11  9  8 
10  11  10  11  10  11  11  10   
9  9  9  10  10  10  11  11  9 
10  10  9  9  10  10  11  11   
11  11  10  9  8  7  10  10  11 
11  12  11  10  10  10  9  9   
13  12  12  10  10  10  11  11  11 
9  8  10  10  11  9  9  8   
12  13  12  12  11  11  10  10  10 
10  10  10  11  12  12  11  13   
14  10  8  7  6  9  10  10  11 
8  9  10  11  10  8  8  7   
9  10  11  10  10  9  9  8  7 
12  10  11  11  10  10  9  9   
10  10  8  7  9  10  11  8  7 
16  15  16  12  10  11  10  14   