12  11  10  11  10  9  11  11  11   
8  9  10  11  11  12  13  14  15  15 
10  9  9  10  10  11  11  12  12   
9  9  9  9  9  9  10  10  11  14 
8  8  9  9  8  7  10  11  12   
11  11  10  11  12  11  8  7  6  6 
10  10  8  8  10  11  11  10  10   
11  10  9  9  8  9  9  11  11  12 
8  7  7  8  7  9  10  10  11   
10  10  11  11  11  12  12  12  12  12 
12  11  10  10  10  9  10  10  10   
10  11  10  9  8  8  8  7  7  9 
7  6  6  5  7  8  9  10  117  9 
7  9  11  12  13  14  12  10  9  8 
8  7  8  9  10  10  11  11  12   
7  8  10  11  9  11  12  14  15  15 
13  12  8  10  14  15  16  16  16   