11  12  14  15  16  12  13  12  10   
15  14  13  12  11  10  9  8  7  6 
10  11  10  10  10  9  9  9  9   
12  10  8  8  10  11  12  13  13  13
12  12  13  10  10  11  9  9  10   
14  14  13  13  10  10  9  9  9  6 
5  5  4  4  6  8  10  12  13   
5  4  4  3  5  6  8  12  13  14
5  4  3  2  3  5  6  8  10   
7  5  5  7  7  9  9  11  14  14
8  8  7  8  8  8  10  11  11   
8  9  9  10  10  11  12  13  14  15
9  8  9  9  10  10  11  12  13   
10  10  9  9  10  10  11  11  12  12 
10  10  11  12  13  14  15  16  17   
8  8  7  9  11  13  12  13  14  15 
5  4  6  5  7  9  11  13  15   