8  12  14  13  11  9  9  10   
7  8  9  10  11  12  13  14  15 
8  8  8  9  9  9  10  10   
9  10  10  12  13  14  15  13  12 
10  10  11  9  10  10  11  11   
11  11  12  12  14  14  15  15  14 
9  9  9  9  8  8  6  6   
9  10  9  9  8  8  7  6  5 
10  10  9  9  8  8  6  6   
12  11  12  12  11  10  10  9  7 
11  12  12  11  10  10  9  9   
7  12  11  8  10  9  9  9  8 
13  13  12  11  10  10  9  9   
14  8  13  13  12  12  11  11  10 
15  14  13  12  11  10  8  10   
14  13  13  11  10  10  9  9  8 
13  12  11  10  9  8  7  6   